1111111111111
20010000000C1
3000011111001
4P0011E000001
5111111111111
