1111111111111
10000000C0001
1000000000001
1000000000001
1111111111111
