1111111111111
100000C001111
100P000011011
10000E0001011
1000000000001
1111111111111
