1111111111111
10000000C0001
1000P00000001
1000E00000001
1111111111111
