1111111111111
100000C000001
100P000010E01
1000000000001
1000000000001
1000000000001
1000000000001
1000000000001
1111111111111
