11111111111
1000000C001
1000P011001
1000000E101
11111111111
