1111111111111
100000C000001
1000001000E01
100P001000001
1111111111111
