1111111111111
1000C00000001
1100P00000001
11111E0000001
1111111111111
