11111111111
10000000001
100P0C0E001
10000000001
11111111111
