11111111111
10000011101
10P0001E101
10000000001
11111111111
