11111111111
1000C00C001
1000P011101
10C0000E101
11111111111
